111111111111111111
1P0000000000000001
1C0000100001111001
100001000010001001
1C0010000000001001
100100001000010001
1C0111111001100001
100000001010000001
1C0000001010001001
100000001011110001
1C0C0C0C0C0C0C0CE1
111111111111111111