111111111
10P00C011
1100001E1
111111111