1111111111111111111
10000000C0000001111
1001011111000001111
10010000CP000001111
1001000000000E01111
1001111111110000C01
1111111111111111111
