1111111111
10P00C1111
1000E11111
1111111111