11111111111
10010E01001
1C100001001
1C1P1110001
11111111111