11111111
11111111
1000CPE1
11111101
11111111

