1111111111111
1000C111111E1
11P1011111111
11110000C00C1
1111111111111