1111111111111
100100C0000C1
1C00011111001
1P0011000000000001
1111111111111